0  0  0  0  0  0  0  0  0  0  0  0
0  0  0  0  0  0  0  0  0  0  0  0
5  5  5  5  5  5  5  5  5  5  5  5
4  4  4  4  4  4  4  4  4  4  4  4
6  6  6  6  6  6  6  6  6  6  6  6
10 10 10 10 5  5  5  5  10 10 10 10 
10 4  4  10 9  9  9  9  10 4  4  10 
10 5  5  10 0  0  0  0  10 6  6  10 
10 0  0  0  0  0  0  0  0  0  0  10 
10 0  0  0  0  0  0  0  0  0  0  10 
10 0  0  0  0  0  0  0  0  0  0  10 
10 0  0  10 4  4  4  4  10 0  0  10 
10 9  9  10 10 10 10 10 10 9  9  10 
