0 0 0 0 0 0 0 0 0 0 0 10
0 0 0 0 0 0 0 0 0 0 0 10
0 0 0 0 0 9 0 0 0 0 0 10
0 0 0 6 6 9 4 4 0 0 0 10
0 0 6 6 1 1 1 4 4 0 0 10
0 6 6 1 1 1 1 1 4 4 0 10
0 6 6 1 1 1 1 1 4 4 0 10
0 6 6 1 1 1 1 1 4 4 0 10
0 9 0 9 0 9 0 9 0 9 0 10
0 0 0 0 0 9 0 0 0 0 0 10
0 0 0 0 0 9 0 0 0 0 0 10
0 0 0 0 0 9 0 0 0 0 0 10
0 0 0 10 0 10 0 0 0 0 0 10
0 0 0 10 10 10 0 0 0 0 0 10
0 0 0 0 10 0 0 0 0 0 0 10