0 0 0 0 0 0 0 0 0 0 0 0
0 0 0 0 0 0 0 0 0 0 0 0
3 9 9 3 3 3 3 3 3 9 9 3
3 9 2 9 3 3 3 3 9 4 9 3
3 9 2 2 9 9 9 9 4 4 9 3
3 9 2 2 2 9 9 4 4 4 9 3
3 9 2 2 2 9 9 4 4 4 9 3
3 9 2 2 2 9 9 4 4 4 9 3
3 9 2 2 2 9 9 4 4 4 9 3
3 9 2 2 2 9 9 4 4 4 9 3
3 9 2 2 2 9 9 4 4 4 9 3
3 3 9 2 2 9 9 4 4 9 3 3
3 3 3 9 2 9 9 4 9 3 3 3
3 3 3 3 9 9 9 9 3 3 3 3




