0 0 0 0 0 0 0 0 0 0 0 0
0 0 0 0 0 0 0 0 0 0 0 0
0 0 0 0 9 9 9 9 9 0 0 0
0 0 0 9 1 1 1 1 1 0 0 0
0 0 9 1 0 0 0 0 0 0 0 0
0 4 4 0 0 0 0 0 0 0 0 0
0 4 4 0 0 0 0 0 0 0 0 0
0 4 4 0 0 3 0 0 0 3 0 0
0 4 4 0 0 3 0 0 0 3 0 0
0 4 4 0 3 9 3 0 3 9 3 0
0 4 4 0 0 3 0 0 0 3 0 0
0 4 4 0 0 3 0 0 0 3 0 0
0 4 4 0 0 0 0 0 0 0 0 0
0 0 9 1 0 0 0 0 0 0 0 0
0 0 0 9 1 1 1 1 1 0 0 0
0 0 0 0 9 9 9 9 9 0 0 0
