0 0 0 0 0 0 0 0 0 0 0 0
0 0 0 0 0 0 0 0 0 0 0 0
0 9 2 4 7 0 0 2 4 6 9 0
0 6 4 2 5 0 0 4 2 9 6 0
0 4 7 5 2 0 0 6 9 2 4 0
0 2 5 7 4 0 0 9 6 4 2 0
0 5 2 4 6 0 0 2 4 7 5 0
0 7 4 2 9 0 0 4 2 5 7 0
0 4 6 9 2 0 0 7 5 2 4 0
0 2 9 6 4 0 0 5 7 4 2 0
0 9 2 4 7 0 0 2 4 6 9 0
0 6 4 2 5 0 0 4 2 9 6 0
0 4 7 5 2 0 0 6 9 2 4 0
0 2 5 7 4 0 0 9 6 4 2 0
0 5 2 4 6 0 0 2 4 7 5 0
0 7 4 2 9 0 0 4 2 5 7 0



