0 0 0 0 0 0 0 0 0 0 0 0
0 0 0 0 0 0 0 0 0 0 0 0
0 0 0 0 0 0 0 0 0 0 0 0
1 0 0 0 0 0 0 0 0 0 0 0
1 2 0 0 0 0 0 0 0 0 0 0
1 2 3 0 0 0 0 0 0 0 0 0
1 2 3 4 0 0 0 0 0 0 0 0
1 2 3 4 6 0 0 0 0 0 0 0
1 2 3 4 6 5 0 0 0 0 0 0
1 2	3 4 6 5 7 0 0 0 0 0
1 2 3 4 6 5 7 8 0 0 0 0
1 2 3 4 6 5 7 8 1 0 0 0
1 2 3 4 6 5 7 8 1 2 0 0
1 2 3 4 6 5 7 8 1 2 3 0
9 9 9 9 9 9 9 9 9 9 9 1